Dog: Perro
Cat: Gato
Run: Correr
Jump: Saltar
Eat: Comer
Sleep: Dormir
Happy: Feliz
Sad: Triste
Big: Grande
Small: Pequeño
Hot: Caliente
Cold: Frío
Fast: Rápido
Slow: Lento
Good: Bueno
Bad: Malo
Nice: Agradable
Ugly: Feo
Red: Rojo
Blue: Azul
Green: Verde
Yellow: Amarillo
Day: Día
Night: Noche
Sun: Sol
Moon: Luna
Star: Estrella
Water: Agua
Fire: Fuego
Tree: Árbol
Flower: Flor
Bird: Pájaro
Fish: Pez
Book: Libro
Pen: Pluma
Paper: Papel
School: Escuela
Home: Casa
Car: Coche
Bike: Bicicleta